3

5 4
1 1 1 1
1 1 0 1
1 1 1 1
1 1 0 0
1 0 0 1
0 1
2 2

5 4
1 1 1 1
1 1 0 1
1 1 1 1
1 1 0 0
1 0 0 1
0 1
4 3

5 4
1 1 1 1
1 1 0 1
1 1 1 1
1 1 0 0
1 0 0 1
0 1
4 0